1111111111111
100100000C001
1000001111101
1PC0110E0C001
1111111111111