111111111111111111111111111
1C0000000000000000000000001
100000000000000000000000001
100000000111110000000000001
100000000010P00000000000001
100000000100010000000000001
100000000111110000000000001
1E0000000000000000000000001
111111111111111111111111111