1111111111111
1E000000000C1
1110011111RR1
1P00100000001
1111111111111