1111111111111111111111111111111111
1E1000000000000C00010C000000000011
1010010100100000101001010000010101
1010110010101011001001000100010101
1000P0010C00C1000000000000010000C1
1111111111111111111111111111111111
1111111111111111111111111111111111
1111111111111111111111111111111111