1111111111111
10000000000C1
1110011111ER1
1P0010CC00CC1
1111111111111