11111111111111111111
1C00P00CC00000000001
1C00CR0CC00000000001
1C00CR0CC00000000001
1C00C00CC00000000001
1CR0000CC00000000001
1CR0R0ECC00000000001
11111111111111111111