1111111111
1C00P00CC1
1C00R00CC1
1C00000CC1
1C0000ECC1
1111111111