1111111111
1000P0C001
1E000C0001
1111111111