111111111111111111111111111
1P0000000000000000000000001
111111111110111111111101111
11000000001C010000000001CE1
101011111011110101111111001
100010010001100000000000001
101111111111100011111111111
100000000000000000000000001
111111111111111111111111111