1111111111111111111111111111
1000P0C000000000000000000001
1110000000000000000000000001
11E0000000000000000000000001
1111111110000000000000000001
1111111111111111111111111111
