1111111111
1000P0C001
1E00000001
1111111111
